000000000000;
211001111000;
001001001000;
001001001113;
001001000000;
001111000000;
000000000000
