000000000000;
001111000000;
001001001113;
001001001000;
001001111000;
211000000000;
000000000000
