000000000000;
001111000000;
001001000000;
001001001113;
001001001000;
211001111000;
000000000000
