000000000000;
211100000000;
000100000000;
000111100000;
000000100000;
000000111113;
000000000000
