000000000000;
000011111100;
000010000100;
001110000100;
001000000100;
211000000113;
000000000000
