002000000000;
001111000000;
000001000000;
001111000000;
001000001113;
001111111000;
000000000000
